##########################
##########################
####,,,,,,,,,,,,,,,,,,####
####,,,W,,,A,,,P,,,M,,####
####,,,,,,,,,,,,,,,,,,####
####,,,,,,,,,,,,,,,,,,####
####,,,,,,,,,,,,,,,,,,####
####,,,,,,,,,,,,,,,,,,####
####,,,,,,,,,,,,,,,,,,####
##########,,,,,###########
##########,,,,,###########