##########################
##########################
####                  ####
####   W   A   P   M  ####
####                  ####
####                  ####
####                  ####
####                  ####
####                  ####
##########     ###########
##########     ###########